NO ./sprites/xpm_images/north.xpm
SO ./sprites/xpm_images/south.xpm
WE ./sprites/xpm_images/west.xpm
EA ./sprites/xpm_images/east.xpm

F 231,156,29
C 38,141,124

11111111111111111111
10000000000000000001
10000000000000000001
1000000000000C0000N1
10000000000000000001
11111111111111111111