NO ./sprites/xpm_images/north.xpm
SO ./sprites/xpm_images/south.xpm
WE ./sprites/xpm_images/west.xpm
EA ./sprites/xpm_images/east.xpm

F 116,212,52
C 135,206,235

11111111111111111111
10000000000000000001
10000000000000000001
10000000000000000001
10S00000000000000001
10000000000000000001
10000000000000000001
10000000000000000001
11111111111111111111