NO ./sprites/xpm_images/south.xpm
SO ./sprites/xpm_images/south.xpm
WE ./sprites/xpm_images/south.xpm
EA ./sprites/xpm_images/south.xpm

F 231,  156,    29
C 38,141,12

 
   
1    
11111111111111111111
10101111111111111101
10000000000000000001
10001000000000N00001
11111111111111111111    1
    
      
        
           
             