NO tests/textures/wall.xp
SO tests/textures/bricks.xpm
WE tests/textures/gold.xpm
EA tests/textures/wood.xpm
F 116,212,52
C 135,206,235

 1111
10001
10001
10N01
10001
10001
11111