NO tests/textures/wall.xp
SO tests/textures/bricks.xpm
WE tests/textures/gold.xpm
EA tests/textures/wood.xpm
F 116,212,52
C 135,206,235

1111111111111111111111
1000000000000010000001
1000010000100010000001
1000000N00000000000001
1000100000101000010001
1000100001001000010001
1111111111111111111111