NO tests/textures/wall.xp
SO tests/textures/bricks.xpm
WE tests/textures/gold.xpm
EA tests/textures/wood.xpm
F 116,212,52
C 135,206,235

11111111111111111111
10000010000000100001
10001100000000010001
10000100000000001001
1010000000S000000001
10000100000000001001
10000100000000001001
11111111111111111111