NO tests/textures/wall.xp
SO tests/textures/bricks.xpm
WE tests/textures/gold.xpm
EA tests/textures/wood.xpm
F 220,111,119
C 225,111,200

1111111111111111111111
1000100000110000000001
1000100000110000000001
1000100N00001001000001
1000001000000010000001
1000000100000000000001
1111111111111111111111