NO ./sprites/xpm_images/south.xpm
SO ./sprites/xpm_images/south.xpm
WE ./sprites/xpm_images/south.xpm
EA ./sprites/xpm_images/south.xpm

F 231,156,29
C 38,141,124

11111111111111111111
10000000000010100001
1E000101010000000001
10001000001010000001
11111111111111111001
10101001001001010001
10000000000000000101
10101001001001010001
10111111111111111111
10100000000000000001
10100000000000000001
10101111111111111101
10000000000000000001
10001000000000000001
11111111111111111111


1111111111111111111111111111111111111111111111111111111111111111
1...................................4..........................1
1...................................4..........................1
1...................................4..........................1
1...111111...1111111111112222...11111111111111111122222....11111
1........2.......4..........2...2..............................1
1........2.......4..........2...2..........................11111
1....1...2...111111111111...........1111111111111111112....13E31
1....1...2............................................2....1...1
111111...2....................P.......................211111...1
1....1...2............................................2....1...1
1....1...1111111111112222...........11111122222.......2....1...1
1............4..............2...2..........................1...1
1............4..............2...2..........................1...1
1...11111...11111111111122222...1111111111111111111111112221...1
1......4.................1........1.......3.......3........3...1
1......4.................1111111111.......3.......3........3...1
1......4..............................3.......3.......3........1
1......4..............................3.......3.......3........1
1111111111111111111111111111111111111111111111111111111111111111