NO ./sprites/xpm_images/north.xpm
SO ./sprites/xpm_images/south.xpm
WE ./sprites/xpm_images/west.xpm
EA ./sprites/xpm_images/east.xpm

F 231,156,29
C 38,141,124

11111111111111111111
10000000000000000001
1E000101000101000001
10001000001000000001
11111111111111111001
10000000000000000001
10000000000000000101
10000000000000000001
10111111111111111111
10100000000000000001
10100000000000000001
10101111111111111101
10000000000000000001
10001000000000000001
11111111111111111111