NO tests/textures/wall.xp
SO tests/textures/bricks.xpm
WE tests/textures/gold.xpm
EA tests/textures/wood.xpm
F 116,212,52
C 135,206,235

11111111111111111111
10000000000000000001
10000100000000000001
10000000000000000001
1000000000S000000001
10000000000010000001
10001000000100000001
11111111111111111111