  
  
 
 
NO    ./sprites/xpm_images/south.xpm
SO      ./sprites/xpm_images/south.xpm
WE      ./sprites/xpm_images/south.xpm
EA ./sprites/xpm_images/south.xpm

F 231,  156,    29
C 38,141,11
1                1
  
  
11111111111111111111
10000000000010100001
1E000101010000000001
10001000001010000001
11111111111111111001
10101001001001010001
10000000000000000101
10101001001001010001
10111111111111111111
10100000000000000001
10100000000000000111
10101011111111111101
10000000000000000001
10001000000000000001
11111111111111111111
111111
 
 
 
 
 