NO tests/textures/wall.xp
SO tests/textures/bricks.xpm
WE tests/textures/gold.xpm
EA tests/textures/wood.xpm
F 116,212,52
C 135,206,235

11111111111111111111
10000000000000000001
10010000100010001001
10100000000000000101
1000000000S000000001
10000000000000000001
10100000100010000101
10010000000000001001
11111111111111111111