NO    ./sprites/xpm_images/south.xpm
SO      ./sprites/xpm_images/south.xpm
WE      ./sprites/xpm_images/south.xpm
EA ./sprites/xpm_images/south.xpm

F 231,156,29
C 38,141,124

1111111111111111111111111111111111111111111111111111111111111111
1000000000000000000000000000000000001000000000000000000000000001
1000000000000000000000000000000000001000000000000000000000000001
1000000000000000000000000000000000001000000000000000000000000001
1000111111000111111111111111100011111111111111111111111000011111
1000000001000000010000000000100010000000000000000000000000000001
1000000001000000010000000000100010000000000000000000000000011111
1000010001000111111111111000000000001111111111111111111000010001
1000010001000000000000000000000000000000000000000000001000010001
11111100010000000000000000000000N0000000000000000000001111110001
1000010001000000000000000000000000000000000000000000001000010001
1000010001111111111111111000000000001111111111100000001000010001
1000000000000100000000000000100010000000000000000000000000010001
1000000000000100000000000000100010000000000000000000000000010001
1000111110001111111111111111100011111111111111111111111111110001
1000000100000000000000000100000000100000001000000010000000010001
1000000100000000000000000111111111100000001000000010000000010001
1000000100000000000000000000000000000010000000100000001000000001
1000000100000000000000000000000000000010000000100000001000000001
1111111111111111111111111111111111111111111111111111111111111111
