NO cub3d-tester/textures/wall.xpm
SO cub3d-tester/textures/bricks.xpm
WE cub3d-tester/textures/gold.xpm
EA cub3d-tester/textures/wood.xpm
F 220,111,119
C 225,111,200

1111
10N01
1001
1111