11111111111111
10010001000101
1001000P000101
10000001000001
11111111111111
