NO ./path_to_the_north_texture   
SO ./path_to_the_south_texture
WE ./path_to_the_west_texture
EA ./path_to_the_east_texture
F 220,100,210
C 225,30,0

1111111111111111111111111
1000000000110000000000001
1011000001110000000000001
1001000000000000000000001
1111111111000100000111001
1000000001000100000111011
1111011111000111011100001
1111011111000000000000001
11000000110N0000000000001
1000000000000000110000001
1000000000000000110101001
1100000111010101111101111
1111011111101011011100001
1111111111111111111111111