11111111111111111111111111111111111111
10000000001100000000000000000000011001
10010000011100000000010000100000111001
10000100001100000101010100000000011001
10000000000000000000000000000000000001
1P000100001100000000000000000000011001
10000000001100000000000000011000011001
11010111100000000011000010101111011001
10010000011100000000010000100000111001
10000000001100000101010100000000011001
11111111111111111111111111111111111111