1111111111
1000000001
1010000011
10000P0001
1000000001
1111111111