1111111111111111111111111
1000000000110000000000001
1001000001110000000001001
1000000000000P00000000001
1101011110110000001100001
1000000000110000010101011
1111111111111111111111111