1111111111111111111111111
1000000000110000000000001
1011000001110000000000001
1001000000000000000000001
1111111110110000011000001
1000000000110000011000001
1111011110111101110000001
1111011110111101110101001
110000001P010101110000001
1000000000000000110000001
1000000000000000110101001
1100000111010101111101111
1111011100111010110111101
1111111100111111111111111