1111111111111111
1000011111000001
10000000P0000001
1000000011000001
1111111111111111