F 255,32,0
C 225,45,45
NO ./path to_the   _north_texture       
SO ./path_to_the_south_texture
WE ./path_to_the_west_texture
EA ./path_to_the_east_texture
 


    1111111111111111111111 11111111111111111111111111 
                      
    11 11111111111111111111 111111111111111111111111111   
    11   1111111111 111111111111000000000110000000000001
1111111111111111111111111011000001110000000000001111111    
1001000000000000000000001111111111111111111111111         
1111111110110000011100000000000010001           
100000000000000010000000010000100011 1     
100000000000000111011111111111111111           
11110111111111011100000010001          
11110111111111011101010010001
11000000110101011100000010001
1000000000000001100000010001111111

11000001110101011111011110N0111111111111111111111111111
11110111 1110101 101111010001000111111 1111111110111101
1 1111111 1111111 11111111111111111      1111111111111