NO tests/textures/wal.xpm
SO tests/textures/bricks.xpm
WE tests/textures/gold.xpm
EA tests/textures/wood.xpm
F 116,212,52
C 135,206,235

           1111111111111111111111111111
          10000000000000000000000000001
          1000000000000000000000000S0001
          1000000000000000000 00000000001
111111111111111111111111111111111111111111