NO tests/textures/wall.xp
SO tests/textures/bricks.xpm
WE tests/textures/gold.xpm
EA tests/textures/wood.xpm
F 220,111,119
C 225,111,200

1111111111111111111111111111111111111111
1000000000000000000000000000000000000001
1000000000000000000000000000000000000001
1000000000000000000000000000000000000001
1000000000000000000000000000000000000001
1000000000000000000000010000000000000001
1000000000000000000000000000000000000001
1000000000000000000E00000000000000000001
1000000000000000000000010000000000000001
1000000000000000000000000000000000000001
1000000000000000000000000000000000000001
1000000000000000000000000000000000000001
1000000000000000000000000000000000000001
1000000000000000000000000000000000000001
1111111111111111111111111111111111111111