11111111111111111111
10001001001001000101
10000000000000001001
10000000000000001001
100000000000P0001001
10000000000010001001
10001000000100000001
11111111111111111111