11111111111111111111
10000010000000100001
10001100000000010001
10000100000000001001
1010000000P000000001
10000100000000001001
10000100000000001001
11111111111111111111