11111111111111111111
10001001001001000101
10000000000000000001
10000000000000000001
1000000000P000000001
10000000000010000001
10001000000100000001
11111111111111111111