111111111111111111111
100000000000000000001
100100011101110001001
100100000000000001001
1000000000P0000000001
100100000000000001001
100100011101110001001
100000000000000000001
111111111111111111111