11111111111111111111
10000010000000000001
10001100000P00001001
10000000000000000001
11111111111111111111