11111111111111111111
10000010000000100001
10001100000P00010001
10000000000000001001
10000000000000000101
11111111111111111111