11111111111111111111
10000010000000100001
10000100000000010001
10001000000000000001
1010000000P000000001
10010000000000010001
10001000000000100001
11111111111111111111