NO ./path_to_the_north_texture
SO ./path_to_the_south_texture
WE ./path to_the_west_texture
EA ./path_to_the_west_texture
F 125,220,125
C 210,25,012


        1111111111111111111111111  
    1    1000000000110000000000001
        10110000011100000000000011
     11  1001000000000000000000001 
1111111110110000011100000000000011
100000000011000001110111111111111 
11110111111111011100000010011111111    
1111011111111101 101010010001
11000000110101011100000010001  
1000000N00000000110000001000111
10000000000000000001101010010001
1100000111010101111101111000111  
11110111 1110101 101111010001 
11111111 1111111 111111111111 